   15   15    25   15    25   20    15   20    15   15   
   20   15    25   15    25   60    20   60    20   15   
   0  30    0  35    25  35    25  30    0  30   
   25  60    25  55    10  55    10  60    25  60   
   15  60    10  60    10  45    15  45    15  60   
   65  0    70  0    70  30    65  30    65  0   
   35  30    40  30    40  15    35  15    35  30   
   35  20    35  15    50  15    50  20    35  20   
   45  15    50  15    50  45    45  45    45  15   
   35  40    35  45    85  45    85  40    35  40   
   80  45    85  45    85  15    80  15    80  45   
   0  70    15  70    15  65    0  65    0  70   
   10  65    15  65    15  85    10  85    10  65   
   10  80    10  85    25  85    25  80    10  80   
   20  85    25  85    25  75    20  75    20  85   
   35  40    40  40    40  70    35  70    35  40   
   25  70    25  65    80  65    80  70    25  70   
   50  55    50  60    100  60    100  55    50  55   
   80  65    80  90    75  90    75  65    80  65   
   80  85    80  90    50  90    50  85    80  85   
   50  85    50  100    55  100    55  85    50  85   
   35  100    40  100    40  75    35  75    35  100   
   35  75    35  80    65  80    65  75    35  75   
